111111
110001
101001
101001
110001
1C0C11
1100C1
100E01
100C01
1010C1
10P101
1000C1
100001
101101
100001
111111
