11111111
1C00C101
1C1C1111
101C0011
10E01011
10100001
1P000001
10000001
10000001
11111111
