1111111111111
101C1101C0101
100011C0E1011
1001P0C000001
1111111111111
