1111111111111111111111111111111111111111
100CE0C1P100C000000000000000000000000001
111C00C10C000000000000000000000000000001
1000100000100000000000000000000000000001
10000000000000C0000000000000000000000001
1111111111111111111111111111111111111111
