111111111111111111
100CE0C00100P100C1
111C00C1110C0C0001
100010000000110001
10000000M000000001
111111111111111111
