111111111111
10CCC0C00101
1010E110C101
1010C1000001
1000CCC00001
11C000100001
1010000P0001
100000000001
100000000001
100000000001
100000000001
100000000001
111111111111
