1111111111
1110C01101
100011C011
1C01C01101
10E00000P1
1000000001
1111111111
