1111111111
10000110E1
11010P0011
1C00100001
1110010001
1111111111
