11111
10001
1E101
10P01
10C01
11111
