11111
100C1
1CC01
10001
10C01
00001
1C001
1P001
10101
10001
110E1
10001
10101
10001
11111
