11111111111
1PE11000001
11100C0C001
1010C00C1C1
10001100001
10110000001
11111111111
